   NO ./graphics/north_wall.png
C 40,40,40
	SO     ./graphics/south_wall2.png


WE ./graphics/west_wall2.png
EA ./graphics/east_wall.png
F 51,35,6

11111
10001
10N0
10001
11111