NO ./graphics/north_wall.png
SO ./graphics/south_wall2.png
WE ./graphics/west_wall2.png
EA ./graphics/east_wall.png
DO ./graphics/door.png
F 51,35,6
C 40,40,40

11111111111 111111111111
1000000000110000101000001
 111000001110000121000001
   100000002000000000001
1111111121110000011100001
1202220001000001110000N1
1111111111111211  111111
          1000001
           10001
            101
             1