NO ./graphics/bellebriquewow.png
SO ./graphics/bellebriquewow.png
WE ./graphics/bellebriquewow.png
EA ./graphics/bellebriquewow.png
F 255,255,255
C 0,0,0

 1111111111111111111111111
1000000000110000000000001
10110000011100000 00000001
100100000000 00000S000001
1111111110110000011100001
1000000000110000011100001
1111111111111111111111111
