NO ./graphics/testimage.png
SO ./graphics/bellebriquewow.png
WE ./graphics/bellebriquewow.png
EA ./graphics/bellebriquewow.png
F 30,30,30
C 48,127,207

11111111111 111111111111
1000000000110000000000001
 111000001110000000000001
   1000000000000000000001
1111111100110000011100001
1000000001100000111S0001
1111111111 11111   11111