   
   
   
   NO ./graphics/north_wall.png
C 40,40,40
	SO     ./graphics/south_wall2.png



WE ./graphics/west_wall2.png
EA ./graphics/east_wall.png
F 51,35,6

11111111111 1111111111111111111111111111
1000000000110000101000001               1
1011000001110000101000000               1
1011000000000000000000001               1
1111111101110000011100001               11111111111111111111111111111111111111111
1000000001000001110000N11                                                       1
10111111111110111 1111111               11111111111111111111111111111111111111111
101       1000000   1   1               1
10111111111100011 1 1 1 1               1
100000000000001   1   1 0               1
11111111111111111111111111111111111111111