   
   
   
   NO ./graphics/north_wall.png
C 40,40,40
	SO     ./graphics/south_wall2.png
DO     ./graphics/door1.png



WE ./graphics/west_wall2.png
EA ./graphics/east_wall.png
F 51,35,6

11111111111 11111111111111111111111111111
1020000000110000101000001               1
1011000001110000121000002               1
1011000000020000000000001               1
1111111121110000011100001               11111111111111111111111111111111111111111
1202220001000001110000N11                                                       1
10111111111112111 1111111               11111111111111111111111111111111111111111
101       1000002   1   1               1
10111111111100011 1 1 1 1               1
100000000002001   1   1 2               1
11111111111111111111111111111111111111111