NO ./graphics/north_wall.png
SO ./graphics/south_wall2.png
WE ./graphics/west_wall2.png
EA ./graphics/east_wall.png
F 30,30,30
C 48,127,207

11111111111 111111111111
1000000000110000000000001
 111000001110000000000001
   100000000000000000001
1111111100110000011100001
1000000001100000111000N1
1111111111 11111   11111