NO ./graphics/bellebriquewow.png
SO ./graphics/bellebriquewow.png
WE ./graphics/bellebriquewow.png
EA ./graphics/bellebriquewow.png
F 255,255,255
C 0,0,0

1111111111111111111111111
1000000000110000000000001
1011000001110000000000001
100100000000000000000000111111111
111111111011000001110000000000001
100000000011000001110111111111111
11110111111111011100000010001
1111011111111101110101001000111111111
1100000011010101110000001000100000001
1000000000000000110000001000111111111
10000000000000001101010010001
1100000111010101111101111000111
11110111011101010101111010001
11111111011111110111111111111