NO ./graphics/bellebriquewow.png
SO ./graphics/bellebriquewow.png
WE ./graphics/bellebriquewow.png
EA ./graphics/bellebriquewow.png
F 255,255,255
C 0,0,0

111111111111111111111111
1000000000110000000000001
10110000011100000 0000001
100100000000 000000N0001
1111111100110000011100001
100000000110000011100001
111111111111111111111111