NO ./graphics/bellebriquewow.png
SO ./graphics/bellebriquewow.png
WE ./graphics/bellebriquewow.png
EA ./graphics/bellebriquewow.png
F 30,30,30
C 48,127,207

1111111111111111111111111
1000000000000000000000001
1000001000000001110000001
1000001000010001010000001
1000111110010001110000001
1000001000010000000000001
1000001000010000111110001
1000000000010000000000001
10000000000100000000N0001
1000000000000000000000001
1111111111111111111111111