NO ./graphics/bellebriquewow.png
SO ./graphics/bellebriquewow.png
WE ./graphics/bellebriquewow.png
EA ./graphics/bellebriquewow.png
F 30,30,30
C 48,127,207

1111111111111111111111111
1000000000110000000000001
1011000001110000000000001
1001000000000000000N0001
1111111100110000011100001
100000000110000011100001
111111111111111111111111